1,1,1,1,1,1,1,1,1,1,1,1,1,1,1,1,1,1,1,1
1,1,1,1,1,1,1,1,1,1,1,1,1,1,1,1,1,1,1,1
1,1,1,1,1,1,1,1,1,1,1,1,1,1,1,1,1,1,1,1
1,1,1,1,1,1,1,5,2,1,1,1,1,1,1,1,1,1,1,1
1,1,1,1,1,1,1,4,3,1,1,1,1,1,1,1,1,1,1,1
1,1,1,1,1,1,1,2,5,1,1,1,1,1,1,1,1,1,1,1
1,1,1,1,1,1,1,5,4,1,1,1,1,1,1,1,1,1,1,1
1,1,1,1,5,5,4,2,3,2,5,2,0,1,1,1,1,1,1,1
1,1,1,1,3,4,2,3,4,5,4,3,0,1,1,1,1,1,1,1
1,1,1,1,2,1,1,4,2,1,1,1,1,1,1,1,1,1,1,1
1,1,1,1,5,3,1,3,5,1,1,1,1,1,1,1,1,1,1,1
1,1,1,1,1,4,2,5,2,1,1,1,1,1,1,1,1,1,1,1
1,1,1,1,1,1,1,1,1,1,1,1,1,1,1,1,1,1,1,1
1,1,1,1,1,1,1,1,1,1,1,1,1,1,1,1,1,1,1,1
1,1,1,1,1,1,1,1,1,1,1,1,1,1,1,1,1,1,1,1
1,1,1,1,1,1,1,1,1,1,1,1,1,1,1,1,1,1,1,1
1,1,1,1,1,1,1,1,1,1,1,1,1,1,1,1,1,1,1,1
1,1,1,1,1,1,1,1,1,1,1,1,1,1,1,1,1,1,1,1
1,1,1,1,1,1,1,1,1,1,1,1,1,1,1,1,1,1,1,1
1,1,1,1,1,1,1,1,1,1,1,1,1,1,1,1,1,1,1,1
