0,0,0,0,0,0,0,0,0,0,0,0,0,0,0,0,0,0,0,0
0,0,0,0,0,0,0,0,0,0,0,0,0,0,0,0,0,0,0,0
0,0,0,0,0,4,3,5,5,4,3,4,3,4,3,0,0,0,0,0
0,0,0,0,0,2,2,4,0,0,0,0,0,0,5,0,0,0,0,0
0,0,0,0,0,2,4,4,0,0,0,0,0,0,3,0,0,0,0,0
0,0,0,0,0,5,5,5,0,0,0,0,0,0,5,0,0,0,0,0
0,0,0,0,0,3,3,4,5,5,2,2,5,3,2,0,0,0,0,0
0,0,0,0,0,5,4,4,2,3,4,4,5,2,2,0,0,0,0,0
0,0,0,0,0,5,5,3,3,5,3,4,2,3,4,0,0,0,0,0
0,0,0,0,0,5,4,2,5,2,3,3,5,5,2,0,0,0,0,0
0,0,0,0,0,2,4,3,2,5,5,3,3,2,5,0,0,0,0,0
0,0,0,0,0,0,0,0,0,0,0,0,0,0,0,0,0,0,0,0
0,0,0,0,0,0,0,0,0,0,0,0,0,0,0,0,0,0,0,0
0,0,0,0,0,0,0,0,0,0,0,0,0,0,0,0,0,0,0,0
0,0,0,0,0,0,0,0,0,0,0,0,0,0,0,0,0,0,0,0
0,0,0,0,0,0,0,0,0,0,0,0,0,0,0,0,0,0,0,0
0,0,0,0,0,0,0,0,0,0,0,0,0,0,0,0,0,0,0,0
0,0,0,0,0,0,0,0,0,0,0,0,0,0,0,0,0,0,0,0
0,0,0,0,0,0,0,0,0,0,0,0,0,0,0,0,0,0,0,0
0,0,0,0,0,0,0,0,0,0,0,0,0,0,0,0,0,0,0,0
