1,1,1,1,1,1,1,1,1,1,1,1,1,1,1,1,1,1,1,1
1,1,1,1,1,1,1,1,1,1,1,1,1,1,1,1,1,1,1,1
1,1,1,1,1,1,1,1,1,1,1,1,1,1,1,1,1,1,1,1
1,1,5,4,5,4,5,4,5,4,5,4,2,5,4,5,4,5,1,1
1,1,4,5,5,2,5,5,2,5,5,2,5,5,5,5,5,4,1,1
1,1,5,4,2,4,3,5,4,5,4,5,4,5,4,2,4,5,1,1
1,1,4,5,5,3,5,5,3,5,5,4,5,5,2,5,5,2,1,1
1,1,5,3,4,5,4,5,4,5,4,5,2,4,4,3,5,4,1,1
1,1,3,5,5,2,5,5,3,5,5,4,5,5,3,5,5,3,1,1
1,1,4,5,4,5,4,2,4,2,4,5,2,5,4,5,2,5,1,1
1,1,3,5,5,5,5,5,3,5,5,2,5,5,3,5,5,4,1,1
1,1,5,2,4,4,2,4,5,3,4,3,5,3,4,5,2,3,1,1
1,1,3,5,5,5,5,5,2,5,5,2,5,5,5,5,5,5,1,1
1,1,4,5,2,4,5,4,5,4,5,4,2,5,4,5,2,3,1,1
1,1,3,4,1,1,1,1,1,1,1,1,1,1,1,1,5,4,1,1
1,1,5,3,1,1,1,1,1,1,1,1,1,1,1,1,0,0,1,1
1,1,1,1,1,1,1,1,1,1,1,1,1,1,1,1,1,1,1,1
1,1,1,1,1,1,1,1,1,1,1,1,1,1,1,1,1,1,1,1
1,1,1,1,1,1,1,1,1,1,1,1,1,1,1,1,1,1,1,1
1,1,1,1,1,1,1,1,1,1,1,1,1,1,1,1,1,1,1,1
