1,1,1,1,1,1,1,1,1,1,1,1,1,1,1,1,1,1,1,1
1,1,1,1,1,1,1,1,1,1,1,1,1,1,1,1,1,1,1,1
1,1,1,1,1,1,1,1,1,1,1,1,1,1,1,1,1,1,1,1
1,1,1,1,1,1,1,1,1,1,1,1,1,1,1,1,1,1,1,1
1,1,1,1,1,1,1,1,1,1,1,1,1,1,1,1,1,1,1,1
1,1,5,2,5,1,1,2,4,2,5,3,4,0,1,1,1,1,1,1
1,1,3,4,3,1,1,3,4,5,4,2,5,0,1,1,1,1,1,1
1,1,1,1,2,1,1,4,2,3,3,1,1,1,1,1,1,1,1,1
1,1,4,3,5,4,3,5,4,2,5,2,4,5,1,1,1,1,1,1
1,1,2,5,4,2,4,5,2,1,1,1,1,2,4,1,1,1,1,1
1,1,5,2,1,1,5,3,4,3,5,3,1,5,2,1,1,1,1,1
1,1,3,4,1,1,3,1,1,1,2,5,1,3,4,1,1,1,1,1
1,1,1,1,1,1,2,3,2,4,4,2,4,2,5,1,1,1,1,1
1,1,1,1,1,1,1,4,5,3,5,1,1,1,1,1,1,1,1,1
1,1,1,1,1,1,1,1,1,1,1,1,1,1,1,1,1,1,1,1
1,1,1,1,1,1,1,1,1,1,1,1,1,1,1,1,1,1,1,1
1,1,1,1,1,1,1,1,1,1,1,1,1,1,1,1,1,1,1,1
1,1,1,1,1,1,1,1,1,1,1,1,1,1,1,1,1,1,1,1
1,1,1,1,1,1,1,1,1,1,1,1,1,1,1,1,1,1,1,1
1,1,1,1,1,1,1,1,1,1,1,1,1,1,1,1,1,1,1,1
