0,0,0,0,0,0,0,0,0,0,0,0,0,0,0,0,0,0,0,0
0,0,0,0,0,0,0,0,0,0,0,0,0,0,0,0,0,0,0,0
0,0,0,10,6,6,6,6,6,6,6,6,6,6,6,6,11,0,0,0
0,0,0,9,0,0,0,0,0,0,0,0,0,0,0,0,7,0,0,0
0,0,0,9,0,0,0,0,0,0,0,0,0,0,0,0,7,0,0,0
0,0,0,9,0,0,0,0,0,0,0,0,0,0,0,0,7,0,0,0
0,0,0,9,0,0,0,16,17,0,16,8,17,0,0,0,7,0,0,0
0,10,6,14,0,0,0,7,9,0,15,11,9,0,0,0,7,0,0,0
0,9,0,0,0,0,0,7,9,0,0,7,9,0,0,0,7,0,0,0
0,9,0,0,0,0,0,7,9,0,0,7,9,0,0,0,7,0,0,0
0,13,8,17,0,0,0,7,13,17,0,7,9,0,0,0,7,0,0,0
0,0,0,9,0,0,0,15,6,14,0,15,14,0,0,0,7,0,0,0
0,0,0,9,0,0,0,0,0,0,0,0,0,0,0,0,7,0,0,0
0,0,0,9,0,0,0,0,0,0,0,0,0,0,0,0,7,0,0,0
0,0,0,9,0,0,0,0,0,0,0,0,0,0,0,0,7,0,0,0
0,0,0,13,8,8,8,8,17,0,0,16,8,8,8,8,12,0,0,0
0,0,0,0,0,0,0,0,9,0,0,7,0,0,0,0,0,0,0,0
0,0,0,0,0,0,0,0,0,0,0,0,0,0,0,0,0,0,0,0
0,0,0,0,0,0,0,0,0,0,0,0,0,0,0,0,0,0,0,0
0,0,0,0,0,0,0,0,0,0,0,0,0,0,0,0,0,0,0,0
