0,0,0,0,0,0,0,0,0,0,0,0,0,0,0,0,0,0,0,0
0,0,0,0,0,0,0,0,0,3,4,5,0,0,0,0,0,0,0,0
0,0,0,0,0,0,0,0,0,2,0,2,0,0,0,0,0,0,0,0
0,0,0,0,0,0,0,0,0,0,3,2,0,0,0,0,0,0,0,0
0,0,0,0,0,0,0,0,0,0,2,0,0,0,0,0,0,0,0,0
0,0,0,0,0,0,0,2,2,5,4,2,2,0,0,0,0,0,0,0
0,0,0,0,0,0,0,3,0,0,2,0,2,0,0,0,0,0,0,0
0,0,0,0,0,0,0,4,0,0,2,0,2,0,0,0,0,0,0,0
0,0,0,0,0,0,0,2,3,2,2,4,2,2,0,0,0,0,0,0
0,0,0,0,0,0,0,0,2,0,2,0,0,2,0,0,0,0,0,0
0,0,0,0,0,0,0,0,5,0,2,0,0,3,0,0,0,0,0,0
0,0,0,0,0,0,0,2,3,5,2,2,3,2,0,0,0,0,0,0
0,0,0,0,0,0,0,2,0,0,2,0,2,0,0,0,0,0,0,0
0,0,0,0,0,0,0,3,0,0,2,0,5,0,0,0,0,0,0,0
0,0,0,0,0,0,0,5,4,2,5,3,4,2,0,0,0,0,0,0
0,0,0,0,0,0,0,0,2,0,2,0,0,2,0,0,0,0,0,0
0,0,0,0,0,0,0,0,4,0,2,0,0,3,0,0,0,0,0,0
0,0,0,0,0,0,0,0,2,5,4,2,5,2,0,0,0,0,0,0
0,0,0,0,0,0,0,0,0,0,0,0,0,0,0,0,0,0,0,0
0,0,0,0,0,0,0,0,0,0,0,0,0,0,0,0,0,0,0,0
