0,0,0,0,0,0,0,0,0,0,0,0,0,0,0,0,0,0,0,0
0,0,0,0,0,0,0,0,0,0,0,0,0,0,0,0,0,0,0,0
0,10,6,6,6,6,6,6,6,6,6,6,6,6,6,6,6,6,11,0
0,9,0,0,0,0,0,0,0,0,0,0,0,0,0,0,0,0,7,0
0,9,0,23,24,0,23,24,0,23,24,0,23,24,0,23,24,0,7,0
0,9,0,0,0,0,0,0,0,0,0,0,0,0,0,0,0,0,7,0
0,9,0,23,24,0,23,24,0,23,24,0,23,24,0,23,24,0,7,0
0,9,0,0,0,0,0,0,0,0,0,0,0,0,0,0,0,0,7,0
0,9,0,23,24,0,23,24,0,23,24,0,23,24,0,23,24,0,7,0
0,9,0,0,0,0,0,0,0,0,0,0,0,0,0,0,0,0,7,0
0,9,0,23,24,0,23,24,0,23,24,0,23,24,0,23,24,0,7,0
0,9,0,0,0,0,0,0,0,0,0,0,0,0,0,0,0,0,7,0
0,9,0,23,24,0,23,24,0,23,24,0,23,24,0,23,24,0,7,0
0,9,0,0,0,0,0,0,0,0,0,0,0,0,0,0,0,0,7,0
0,9,0,0,16,8,8,8,8,8,8,8,8,8,8,17,0,0,7,0
0,9,0,0,7,0,0,0,0,0,0,0,0,0,0,9,0,0,7,0
0,13,8,8,12,0,0,0,0,0,0,0,0,0,0,0,0,0,0,0
0,0,0,0,0,0,0,0,0,0,0,0,0,0,0,0,0,0,0,0
0,0,0,0,0,0,0,0,0,0,0,0,0,0,0,0,0,0,0,0
0,0,0,0,0,0,0,0,0,0,0,0,0,0,0,0,0,0,0,0
