0,0,0,0,0,0,0,0,0,0,0,0,0,0,0,0,0,0,0,0
0,0,0,66,66,66,0,0,0,0,0,0,0,0,66,66,66,0,0,0
0,0,66,0,0,0,66,0,0,0,0,0,0,66,0,0,0,66,0,0
0,66,0,0,0,0,0,66,0,0,0,0,66,0,0,0,0,0,66,0
0,66,0,0,0,0,0,66,0,0,0,0,66,0,0,0,0,0,66,0
0,66,0,0,0,0,0,66,0,0,0,0,66,0,0,0,0,0,66,0
0,0,66,0,0,0,66,0,0,0,0,0,0,66,0,0,0,66,0,0
0,0,0,66,66,66,0,0,0,0,0,0,0,0,66,66,66,0,0,0
0,0,0,0,0,0,0,0,0,0,0,0,0,0,0,0,0,0,0,0
0,0,0,0,0,0,0,0,0,0,0,0,0,0,0,0,0,0,0,0
0,0,0,0,0,0,0,0,0,0,0,0,0,0,0,0,0,0,0,0
0,0,0,0,0,0,0,0,0,0,0,0,0,0,0,0,0,0,0,0
0,0,0,66,66,66,0,0,0,0,0,0,0,0,66,66,66,0,0,0
0,0,66,0,0,0,66,0,0,0,0,0,0,66,0,0,0,66,0,0
0,66,0,0,0,0,0,66,0,0,0,0,66,0,0,0,0,0,66,0
0,66,0,0,0,0,0,66,0,0,0,0,66,0,0,0,0,0,66,0
0,66,0,0,0,0,0,66,0,0,0,0,66,0,0,0,0,0,66,0
0,0,66,0,0,0,66,0,0,0,0,0,0,66,0,0,0,66,0,0
0,0,0,66,66,66,0,0,0,0,0,0,0,0,66,66,66,0,0,0
0,0,0,0,0,0,0,0,0,0,0,0,0,0,0,0,0,0,0,0
