1,1,1,1,1,1,1,1,1,1,1,1,1,1,1,1,1,1,1,1,1,1,1,1,1,1,1,1,1,1
1,1,1,1,1,1,1,1,1,1,1,1,1,1,1,1,1,1,1,1,1,1,1,1,1,1,1,1,1,1
1,1,1,1,1,1,1,1,1,1,1,1,1,1,1,1,1,1,1,1,1,1,1,1,1,1,1,1,1,1
1,1,1,1,1,1,1,1,1,1,1,1,1,1,1,1,1,1,1,1,1,1,1,1,1,1,1,1,1,1
1,1,1,1,1,1,1,1,1,1,1,1,1,1,1,1,1,1,1,1,1,1,1,1,1,1,1,1,1,1
1,1,1,1,1,1,1,1,1,1,1,1,1,1,1,1,1,1,1,1,1,1,1,1,1,1,1,1,1,1
1,1,1,2,3,2,1,1,2,3,2,1,1,2,2,2,1,1,3,2,2,1,1,1,1,1,1,1,1,1
1,1,1,2,2,4,1,1,5,5,2,1,1,3,3,3,1,1,2,4,4,1,1,1,1,1,1,1,1,1
1,1,1,2,2,2,1,1,2,2,2,1,1,2,2,2,1,1,2,2,2,1,1,1,1,1,1,1,1,1
1,1,1,2,2,2,2,2,2,2,2,2,2,5,4,2,2,5,2,5,2,5,2,2,1,1,1,1,1,1
1,1,1,2,4,2,2,5,4,4,2,2,3,5,2,5,2,2,5,3,4,2,2,4,1,1,1,1,1,1
1,1,1,2,2,2,1,1,2,2,2,1,1,2,2,2,1,1,2,2,2,1,1,1,1,1,1,1,1,1
1,1,1,2,3,3,1,1,3,5,2,1,1,2,2,2,1,1,2,2,2,1,1,1,1,1,1,1,1,1
1,1,1,2,2,2,1,1,2,4,2,1,1,2,3,2,1,1,2,4,2,1,1,1,1,1,1,1,1,1
1,1,1,1,1,1,1,1,1,1,1,1,1,1,1,1,1,1,1,1,1,1,1,1,1,1,1,1,1,1
1,1,1,1,1,1,1,1,1,1,1,1,1,1,1,1,1,1,1,1,1,1,1,1,1,1,1,1,1,1
1,1,1,1,1,1,1,1,1,1,1,1,1,1,1,1,1,1,1,1,1,1,1,1,1,1,1,1,1,1
1,1,1,1,1,1,1,1,1,1,1,1,1,1,1,1,1,1,1,1,1,1,1,1,1,1,1,1,1,1
1,1,1,1,1,1,1,1,1,1,1,1,1,1,1,1,1,1,1,1,1,1,1,1,1,1,1,1,1,1
1,1,1,1,1,1,1,1,1,1,1,1,1,1,1,1,1,1,1,1,1,1,1,1,1,1,1,1,1,1
