0,0,0,0,0,0,0,0,0,0,0,0,0,0,0,0,0,0,0,0
0,0,0,0,0,0,0,0,0,0,0,0,0,0,0,0,0,0,0,0
0,0,0,0,0,0,54,50,55,0,0,0,0,0,0,0,0,0,0,0
0,0,0,0,0,0,53,67,59,50,55,0,0,0,0,0,0,0,0,0
0,0,0,0,0,0,53,0,66,67,59,50,55,0,0,0,0,0,0,0
0,0,0,0,54,50,58,0,66,0,66,67,51,0,0,0,0,0,0,1
0,0,0,0,53,0,0,0,0,0,0,0,51,0,0,0,0,0,0,0
0,0,0,0,57,52,61,0,66,0,66,0,59,50,55,0,0,0,0,0
0,0,0,0,0,0,53,0,0,0,0,0,0,0,51,0,0,0,0,0
0,0,0,0,0,0,53,69,66,0,66,0,60,52,56,0,0,0,0,0
0,0,0,0,0,0,57,52,61,69,66,0,51,0,0,0,0,0,0,0
0,0,0,0,0,0,0,0,57,52,61,69,51,0,0,0,0,0,0,0
0,0,0,0,0,0,0,0,0,0,57,52,56,0,0,0,0,0,0,0
0,0,0,0,0,0,0,0,0,0,0,0,0,0,0,0,0,0,0,0
0,0,0,0,0,0,0,0,0,0,0,0,0,0,0,0,0,0,0,0
